NO ./textures/wall2.xpm
SO ./textures/walls.xpm 
EA ./textures/owl.xpm 
WE ./textures/ghost.xpm  


C 200,200,200    
 F 	96,96,96       

111111111111111111111111 11111111111111111111111111
10000000000000000000000010000000000000000000000001
10000000000000000000000000000000000000000000000001
10000000000000000000000000000000000000000000000001
10000000000000000000000000000000000000000000000001
10000000000000000000000000000000000000000000000001
10000000000000000000000000000000000000000000000001
100000000000000000000000N0000000000000000000000001
1000000000000000000000000000000000000000000000001
10000000000000000000000000000000000000000000000001
10000000000000000000000000000000000000000000000001
10000000000000000000000000000000000000000000000001
10000000000000000000000000000000000000000000000001
10000000000000000000000000000000000000000000000001
10000000000000000000000000000000000000000000000001
10000000000000000000000100000000000000000000000001
11111111111111111111111 11111111111111111111111111
