
R    800 600

                SO textures/8.xpm
                        WE textures/9.xpm
        NO textures/7.xpm
                        EA textures/15.xpm
                S  textures/s.xpm
        F       202,161,22  
  C       119,181,245
 

     1   1   1   1   1   1   1   1   1   1   1   1   1   1   1   1   1   1   1   1   1   111111111111
    101 101 101 101 101 101 101 101 101 101 101 101 101 101 101 101 101 101 101 101 101 1000000000000111111111
   10001000100010001000100010001000100010001000100010001000100010001000100010001000100010000110001100000000001
  100000000000000000000000000000000000000000000000000000000000000000000000000000000000000001  101  10000000001
 10011110001100001100011110001111111000111111111000111110001100001100011111100000000000000001  1  100000000021
1001    101  1001  101    101       101         101     101  1001  101      100000000000000001   1000000000001
1201   1101  1001  101  11101  11111001   111   101  111101  1001  10011  110000000000000000001 10000000000021
1001  10001  1001  101  10001  10000001   1 1   101  100001  1001  10001  100111001110111011100100111101110001
1201  10001  1111  101  11101  10000001   111   101  111001  1111  10001  100101000010001010100000100101000001
1001  10001        101    101  10111101         101     101        10001  100001001110111000101110111001011101
1201  10001  1111  101  11101  101  101  11111  1001111 101  1111  10001  100001000010001000100000100101001001
1001  10001  1001  101  10001  1001 101  10001  1000001 101  1001  10001  100011101110111000100000111001111021
1201   1101  1001  101  11101  1111 101  10001  1011111 101  1001  10011  100000000000000000000000000000000001
1001    101  1001  101    101       101  10001  101     101  1001  101     11000202020202020202020202020200001
12001111000110001110001111000111111100011000011100011111000110000110001111110011111111111111111111111111111101   
120000000000000000000000000000000000000000000000000000000000000000000000000001                             101
 12000000000000000000000000000000000000000000000000000000000000000000000000001                             101
  1200000000001100110111100100010111011101000100100111001001001111000000000001                             101
   120000000011001100000110110010100001001000101 10101001010011000000000000001                             101
    10000000110011000001100101010111001001010101 10110001100001100000000000001                             101
     1200001111110011111000100110100001001101101 10101001010000111110000000001                             101
      120000001100110000000100010111001000101000100100101001000000011000000021                             101
       12000011000110000000000000000000000000000000000000000000000011000000001                             101
        1200110000111111111111111111111111111111111111111111111111111000000021                             101
         100000000000000000000000000000000000000000000000000000000000000N0000111111111111111111111111111111101
          1222222222222222222222222222222222222222222222222222222222222000000000000000000000000000000000000001  
           111111111111111111111111111111111111111111111111111111111111111111111111111111111111111111111111111


R  901 901
        NO textures/2.exe

                SO textures/2.exe
                        WE textures/3.xpm
                        EA textures/s.xpm
                S  textures/s.xpm
        F       202,161,22
C       119 ,181 ,1

     
11111111111
 1111111111111 
1N00000000001
1000002000001
1000000000001
11111111111111


R 110990 1100

        NO textures/3.xpm
                SO textures/8.xpm
                        WE textures/9.xpm
                        EA textures/15.xpm
                S  textures/s.xpm
        F       202,161,22  
  C       119,181,245
 



111                                                     1111111111111111111111111111111111111111111
101                                                     10000000000000000000000000000000000000000011
111                                                     100000000000000000000000000000000000000000011
                                                        1000000000000000000000000000000000000000000011
              1111111  111111111111111111111            10000000000000000000000000000000000000000000011
           1111100001  100011111000000001001            100000000000000000000000000000000000000000000011
        1111100000001  100000011110111111101            10000000000000000000000000N0000000000000000000011
  1111111100000000001  10000000000011    101            10000000000000000000000000000000000000000000000011
  1000000000000000001  10000000000111   11011111111     100000000000000000000000000000000000000000000000011
  1100000000000000001  10000000000001   11000000001     1000000000000000000000000000000000000000000000000011
  1111111111111111111  11111110111111   11111111101     10000000000000000000000000200000000000000000000000011
                            10001               101     100000000000000000000000021200000000000000000000000011
  11111111111111111     111110001111111111111   101111  1000000000000000000000002111200000000000000000000000011
 111000000000000011    1100000000000000000001   100001  10000000000000000000000211 11200000000000000000000000011
  10000000000000001    1000000000000000000001   1100011 1000000000000000000000211   11200000000000000000000000011
  11000000000000011    1100000001110111110001   1000001 10000000000000000000000211 11200000000000000000000000011
  1000000000000001      1000000011101   10001   1000001 1000000000000000000000002111200000000000000000000000011
  11100000000000011111111000000011101   10001   11000011100000000000000000000000021200000000000000000000000011
   1111000000000000001000000000000001   10001  11100000000000000000000000000000000200000000000000000000000011
   1100000000000000000000000001111111   11111  1000111111000000000000000000000000000000000000000000000000011
   11111000001100000000000000000001            10001    100000000000000000000000000000000000000000000000011
 111000000000000000000000000001111111111111111110001    10000000000000000000000000000000000000000000000011
 111111000000000000000000000000000000000000000000001    1000000000000000000000000000000000000000000000011
     11111100000000000000000011111111111111111000001    100000000000000000000000000000000000000000000011
         1111110000000000111111            111111111    10000000000000000000000000000000000000000000011
             11111111111111                             1000000000000000000000000000000000000000000011
                                                        100000000000000000000000000000000000000000011
                                                        10000000000000000000000000000000000000000011
                                                        1111111111111111111111111111111111111111111 


R  800 800
NO textures/4.xpm
SO textures/6.xpm
WE textures/7.xpm
EA textures/8.xpm
S textures/sprite_4.xpm
F 202,161,82
C 119,181,245


     1   1   1   1   1   1   1   1   1   1   1   1   1   1   1   1   1   1   1   1   1   11111 1111   1   1
    101 101 101 101 101 101 101 101 101 101 101 101 101 101 101 101 101 101 101 101 101 100000100001 101 101
   1000100010001000100010001000100010001000100010001000100010000000100010001000100010001000110001100100010001
  10000000000000000000000000000000000000000000000000000000000000000000000000000000000000001  101  10000000001
 1011110001100001100011110001111111000111111111000111110001100001100011111100000000000000001  1  100000000001
101    101  1001  101    101       101         101     101  1001  101      100000000000000001   1000000000001
101   1101  1001  101  11101  11111001   111   101  111101  1001  10011  110000000000000000001 10000000000001
101  10001  1001  101  10001  10000001   1 1   101  100001  1001  10001  100111001110111011100100111101110001
101  10001  1111  101  11101  10000001   111   101  111001  1111  10001  100101000010001010100000100101000001
101  10001        101    101  10111101         101     101        10001  100001001110111000101110111001011101
101  10001  1111  101  11101  101  101  11111  1001111 101  1111  10001  100001000010001000100000100101001001
101  10001  1001  101  10001  1001 101  10001  1000001 101  1001  10001  100011101110111000100100111001111001
101   1101  1001  101  11101  1111 101  10001  1011111 101  1001  10011  100000000000000000001 10000000000001
101    101  1001  101    101       101  10001  101     101  1001  101      100211111111111111   1111111111111
1001111000110001110001111000111111100011000011100011111000110000110001111110021    
 100000000000000000000000000000000000000000000000000000W0000000000000000000021 
  100000000001100110111100100010111011101000100100111001001001111000000000021  
   10000000011001100000110110010100001001000101 1010100101001100000000000021 
    1000000110011000001100101010111001001010101 101100011000011000000000001   
     100001111110011111000100110100001001101101 10101001010000111110000021     
      1000000110011000000010001011100100010100010010010100100000001100001  
       10000110001100000000000000000000000000000000000000000000000110001    
        100110000111111111111111111111111111111111111111111111111111001    
         1000000000000000000000000000000000000000000000000000000000001     
          11111111111111111111111111111111111111111111111111111111111 